PPPPPPPPPPPPPPP
PiFcIPiciPicFiP
PcPPcPcPcPCPPcP
PiciiPiciciiciP
PCPCPPCPPPPCPPP
PicicIiccIciciP
PCPPPcPPPcPPPcP
PiciPicJciPiciP
PcPcPcPPPcPcPcP
PcPcPiciPcPcPcP
PcPiCiPicIcIPcP
PcPcPcPPPPPcPFP
PcPcPcPiCiPcPcP
PiFiPIciPicIciP
PPPPPPPPPPPPPPP