PPPPPPPPPPPPPPP
PiCFcicciPicciP
PcPPPcPPcPcPPcP
PiciciPPcPcPPcP
PcPcPiCciFiPiiP
PicCciPPcPPPcPP
PPPPPcPPcPPiiiP
PicccIcciiccPcP
PcPPPcPPPcPcPFP
PiciPicJciPiciP
PPPcPcPPPIciPcP
PiciPiciPcPcPcP
PcPPPPPcPcPcPcP
PicFccciCiciciP
PPPPPPPPPPPPPPP
